............................................................
............................................................
............................................................
............................................................
............................................................
............................................................
............................................................
...............~~~~~........................................
............................................................
............................................................
............................................................
............................................................
............................................................
............................................................
............................................................
......######..........................................######
......#....#................................................
......#....#.....................................###........
......######............................####................
............................................................
............................######..........................
............................................................
............................................................
.....................................######.................
............................................................
............................................................
.............................####...........................
............................................................
............................................................
.....................................#####..................
..####......###.......#######......................#####....
............................................................
............................................................
%%%%%%%%%%%%%%%%%%%%%%%%%%%%%%%%%%%%%%%%%%%%%%%%%%%%%%%%%%%%
