............................................................
............................................................
............................................................
............................................................
............................................................
............................................................
............................................................
...............~~~~~........................................
............................................................
............................................................
.........########...................######..................
............................................................
............................................................
............................................................
................#################...........................
......................................................######
............................................................
........C........................................###........
......######............................####................
.............................$$$$...........................
............................######..........................
............................................................
............########........................................
.....................................######.................
............................................................
............................................................
.............................####...........................
........##############......................................
.......................................*....................
....C..................$$$...........#####..........*.......
..####......###.......#######...............############....
............................................................
%%%%%%%%%%%%%%%%%%%%%%%%%%%%%%%%%%%%%%%%%%%%%%%%%%%%%%%%%%%%
%%%%%%%%%%%%%%%%%%%%%%%%%%%%%%%%%%%%%%%%%%%%%%%%%%%%%%%%%%%%
